"filename", "language", "JSON", "Markdown", "C#", "UnityShader", "comment", "blank", "total"
"e:\UNITY\Unity Learning\Project2D\Assets\TextMesh Pro\Shaders\TMP_Bitmap-Custom-Atlas.shader", "UnityShader", 0, 0, 0, 109, 2, 33, 144
"e:\UNITY\Unity Learning\Project2D\Assets\TextMesh Pro\Shaders\TMP_Bitmap-Mobile.shader", "UnityShader", 0, 0, 0, 112, 3, 31, 146
"e:\UNITY\Unity Learning\Project2D\Assets\TextMesh Pro\Shaders\TMP_Bitmap.shader", "UnityShader", 0, 0, 0, 109, 2, 33, 144
"e:\UNITY\Unity Learning\Project2D\Assets\TextMesh Pro\Shaders\TMP_SDF Overlay.shader", "UnityShader", 0, 0, 0, 243, 4, 71, 318
"e:\UNITY\Unity Learning\Project2D\Assets\TextMesh Pro\Shaders\TMP_SDF SSD.shader", "UnityShader", 0, 0, 0, 241, 4, 66, 311
"e:\UNITY\Unity Learning\Project2D\Assets\TextMesh Pro\Shaders\TMP_SDF-Mobile Masking.shader", "UnityShader", 0, 0, 0, 188, 10, 50, 248
"e:\UNITY\Unity Learning\Project2D\Assets\TextMesh Pro\Shaders\TMP_SDF-Mobile Overlay.shader", "UnityShader", 0, 0, 0, 183, 8, 50, 241
"e:\UNITY\Unity Learning\Project2D\Assets\TextMesh Pro\Shaders\TMP_SDF-Mobile SSD.shader", "UnityShader", 0, 0, 0, 82, 4, 21, 107
"e:\UNITY\Unity Learning\Project2D\Assets\TextMesh Pro\Shaders\TMP_SDF-Mobile.shader", "UnityShader", 0, 0, 0, 183, 8, 50, 241
"e:\UNITY\Unity Learning\Project2D\Assets\TextMesh Pro\Shaders\TMP_SDF-Surface-Mobile.shader", "UnityShader", 0, 0, 0, 103, 8, 28, 139
"e:\UNITY\Unity Learning\Project2D\Assets\TextMesh Pro\Shaders\TMP_SDF-Surface.shader", "UnityShader", 0, 0, 0, 122, 4, 33, 159
"e:\UNITY\Unity Learning\Project2D\Assets\TextMesh Pro\Shaders\TMP_SDF.shader", "UnityShader", 0, 0, 0, 243, 4, 71, 318
"e:\UNITY\Unity Learning\Project2D\Assets\TextMesh Pro\Shaders\TMP_Sprite.shader", "UnityShader", 0, 0, 0, 97, 0, 20, 117
"e:\UNITY\Unity Learning\Project2D\Assets\TextMesh Pro\Shaders\TMPro.cginc", "UnityShader", 0, 0, 0, 63, 2, 20, 85
"e:\UNITY\Unity Learning\Project2D\Assets\TextMesh Pro\Shaders\TMPro_Mobile.cginc", "UnityShader", 0, 0, 0, 122, 2, 34, 158
"e:\UNITY\Unity Learning\Project2D\Assets\TextMesh Pro\Shaders\TMPro_Properties.cginc", "UnityShader", 0, 0, 0, 62, 10, 14, 86
"e:\UNITY\Unity Learning\Project2D\Assets\TextMesh Pro\Shaders\TMPro_Surface.cginc", "UnityShader", 0, 0, 0, 76, 7, 19, 102
"e:\UNITY\Unity Learning\Project2D\Assets\TextMesh Pro\Sprites\EmojiOne.json", "JSON", 155, 0, 0, 0, 0, 2, 157
"e:\UNITY\Unity Learning\Project2D\Assets\_Data\Abilities\Abilities.cs", "C#", 0, 0, 18, 0, 0, 4, 22
"e:\UNITY\Unity Learning\Project2D\Assets\_Data\Abilities\AbilitiesCode.cs", "C#", 0, 0, 19, 0, 0, 4, 23
"e:\UNITY\Unity Learning\Project2D\Assets\_Data\Abilities\AbilityHeal.cs", "C#", 0, 0, 49, 0, 1, 9, 59
"e:\UNITY\Unity Learning\Project2D\Assets\_Data\Abilities\AbilityMagnatic.cs", "C#", 0, 0, 81, 0, 0, 15, 96
"e:\UNITY\Unity Learning\Project2D\Assets\_Data\Abilities\AbilityMissle.cs", "C#", 0, 0, 36, 0, 0, 5, 41
"e:\UNITY\Unity Learning\Project2D\Assets\_Data\Abilities\AbilityShield.cs", "C#", 0, 0, 63, 0, 0, 14, 77
"e:\UNITY\Unity Learning\Project2D\Assets\_Data\Abilities\AbilitySummon.cs", "C#", 0, 0, 24, 0, 0, 5, 29
"e:\UNITY\Unity Learning\Project2D\Assets\_Data\Abilities\AbilitySummonEnemy.cs", "C#", 0, 0, 45, 0, 1, 9, 55
"e:\UNITY\Unity Learning\Project2D\Assets\_Data\Abilities\AbilityWarp.cs", "C#", 0, 0, 92, 0, 2, 18, 112
"e:\UNITY\Unity Learning\Project2D\Assets\_Data\Abilities\AbilityWarpByKey.cs", "C#", 0, 0, 13, 0, 0, 4, 17
"e:\UNITY\Unity Learning\Project2D\Assets\_Data\Abilities\BaseAbility.cs", "C#", 0, 0, 39, 0, 1, 10, 50
"e:\UNITY\Unity Learning\Project2D\Assets\_Data\AkiBehaviour.cs", "C#", 0, 0, 22, 0, 3, 7, 32
"e:\UNITY\Unity Learning\Project2D\Assets\_Data\Buff\BuffAbstract.cs", "C#", 0, 0, 18, 0, 0, 5, 23
"e:\UNITY\Unity Learning\Project2D\Assets\_Data\Buff\BuffCode.cs", "C#", 0, 0, 21, 0, 0, 4, 25
"e:\UNITY\Unity Learning\Project2D\Assets\_Data\Buff\BuffCtrl.cs", "C#", 0, 0, 25, 0, 1, 8, 34
"e:\UNITY\Unity Learning\Project2D\Assets\_Data\Buff\BuffDespawn.cs", "C#", 0, 0, 13, 0, 0, 3, 16
"e:\UNITY\Unity Learning\Project2D\Assets\_Data\Buff\BuffDropRate.cs", "C#", 0, 0, 7, 0, 0, 2, 9
"e:\UNITY\Unity Learning\Project2D\Assets\_Data\Buff\BuffGrabber.cs", "C#", 0, 0, 49, 0, 0, 8, 57
"e:\UNITY\Unity Learning\Project2D\Assets\_Data\Buff\BuffHandler\AttackBuffHandler.cs", "C#", 0, 0, 20, 0, 2, 5, 27
"e:\UNITY\Unity Learning\Project2D\Assets\_Data\Buff\BuffHandler\AttackSpeedBuffHandler.cs", "C#", 0, 0, 19, 0, 0, 5, 24
"e:\UNITY\Unity Learning\Project2D\Assets\_Data\Buff\BuffHandler\BuffHandler.cs", "C#", 0, 0, 48, 0, 1, 10, 59
"e:\UNITY\Unity Learning\Project2D\Assets\_Data\Buff\BuffHandler\LuckBuffHandler.cs", "C#", 0, 0, 19, 0, 0, 5, 24
"e:\UNITY\Unity Learning\Project2D\Assets\_Data\Buff\BuffHandler\SpeedBuffHandler.cs", "C#", 0, 0, 19, 0, 1, 5, 25
"e:\UNITY\Unity Learning\Project2D\Assets\_Data\Buff\BuffPickupable.cs", "C#", 0, 0, 26, 0, 0, 9, 35
"e:\UNITY\Unity Learning\Project2D\Assets\_Data\Buff\BuffProfileSO.cs", "C#", 0, 0, 20, 0, 0, 5, 25
"e:\UNITY\Unity Learning\Project2D\Assets\_Data\Buff\BuffSpawner.cs", "C#", 0, 0, 39, 0, 40, 11, 90
"e:\UNITY\Unity Learning\Project2D\Assets\_Data\Bullet\BulletAbstract.cs", "C#", 0, 0, 17, 0, 0, 4, 21
"e:\UNITY\Unity Learning\Project2D\Assets\_Data\Bullet\BulletCtrl.cs", "C#", 0, 0, 38, 0, 0, 10, 48
"e:\UNITY\Unity Learning\Project2D\Assets\_Data\Bullet\BulletDamageSender.cs", "C#", 0, 0, 23, 0, 0, 6, 29
"e:\UNITY\Unity Learning\Project2D\Assets\_Data\Bullet\BulletDespawn.cs", "C#", 0, 0, 9, 0, 0, 2, 11
"e:\UNITY\Unity Learning\Project2D\Assets\_Data\Bullet\BulletFly.cs", "C#", 0, 0, 10, 0, 0, 2, 12
"e:\UNITY\Unity Learning\Project2D\Assets\_Data\Bullet\BulletImpact.cs", "C#", 0, 0, 35, 0, 0, 8, 43
"e:\UNITY\Unity Learning\Project2D\Assets\_Data\Bullet\BulletSpawner.cs", "C#", 0, 0, 16, 0, 0, 4, 20
"e:\UNITY\Unity Learning\Project2D\Assets\_Data\Bullet\MissleDespawn.cs", "C#", 0, 0, 61, 0, 0, 13, 74
"e:\UNITY\Unity Learning\Project2D\Assets\_Data\Bullet\MissleFly.cs", "C#", 0, 0, 10, 0, 0, 2, 12
"e:\UNITY\Unity Learning\Project2D\Assets\_Data\Despawn\Despawn.cs", "C#", 0, 0, 17, 0, 0, 6, 23
"e:\UNITY\Unity Learning\Project2D\Assets\_Data\Despawn\DespawnByDis.cs", "C#", 0, 0, 20, 0, 1, 5, 26
"e:\UNITY\Unity Learning\Project2D\Assets\_Data\Despawn\DespawnByTime.cs", "C#", 0, 0, 19, 0, 0, 4, 23
"e:\UNITY\Unity Learning\Project2D\Assets\_Data\FX\FXDespawn.cs", "C#", 0, 0, 13, 0, 0, 2, 15
"e:\UNITY\Unity Learning\Project2D\Assets\_Data\FX\FXSpawner.cs", "C#", 0, 0, 21, 0, 0, 4, 25
"e:\UNITY\Unity Learning\Project2D\Assets\_Data\HPBar\HPBarSpawner.cs", "C#", 0, 0, 21, 0, 0, 7, 28
"e:\UNITY\Unity Learning\Project2D\Assets\_Data\InputHotKeyManager.cs", "C#", 0, 0, 31, 0, 0, 6, 37
"e:\UNITY\Unity Learning\Project2D\Assets\_Data\InputManager.cs", "C#", 0, 0, 48, 0, 6, 9, 63
"e:\UNITY\Unity Learning\Project2D\Assets\_Data\Item\Inventory\Inventory.cs", "C#", 0, 0, 135, 0, 4, 27, 166
"e:\UNITY\Unity Learning\Project2D\Assets\_Data\Item\Inventory\InventoryAbstract.cs", "C#", 0, 0, 17, 0, 0, 4, 21
"e:\UNITY\Unity Learning\Project2D\Assets\_Data\Item\Inventory\ItemInventory.cs", "C#", 0, 0, 37, 0, 3, 10, 50
"e:\UNITY\Unity Learning\Project2D\Assets\_Data\Item\Inventory\ItemInventoryDrop.cs", "C#", 0, 0, 28, 0, 2, 9, 39
"e:\UNITY\Unity Learning\Project2D\Assets\_Data\Item\Inventory\ItemLooter.cs", "C#", 0, 0, 36, 0, 0, 7, 43
"e:\UNITY\Unity Learning\Project2D\Assets\_Data\Item\Inventory\ItemPickupable.cs", "C#", 0, 0, 32, 0, 0, 9, 41
"e:\UNITY\Unity Learning\Project2D\Assets\_Data\Item\Inventory\ItemRecipe.cs", "C#", 0, 0, 8, 0, 0, 3, 11
"e:\UNITY\Unity Learning\Project2D\Assets\_Data\Item\Inventory\ItemRecipeIngredients.cs", "C#", 0, 0, 9, 0, 0, 3, 12
"e:\UNITY\Unity Learning\Project2D\Assets\_Data\Item\Inventory\ItemUpgrade.cs", "C#", 0, 0, 58, 0, 2, 16, 76
"e:\UNITY\Unity Learning\Project2D\Assets\_Data\Item\ItemAbstract.cs", "C#", 0, 0, 18, 0, 0, 5, 23
"e:\UNITY\Unity Learning\Project2D\Assets\_Data\Item\ItemCode.cs", "C#", 0, 0, 20, 0, 0, 4, 24
"e:\UNITY\Unity Learning\Project2D\Assets\_Data\Item\ItemCtrl.cs", "C#", 0, 0, 37, 0, 2, 12, 51
"e:\UNITY\Unity Learning\Project2D\Assets\_Data\Item\ItemDespawn.cs", "C#", 0, 0, 13, 0, 0, 3, 16
"e:\UNITY\Unity Learning\Project2D\Assets\_Data\Item\ItemDropRate.cs", "C#", 0, 0, 7, 0, 0, 2, 9
"e:\UNITY\Unity Learning\Project2D\Assets\_Data\Item\ItemDropSpawner.cs", "C#", 0, 0, 70, 0, 6, 11, 87
"e:\UNITY\Unity Learning\Project2D\Assets\_Data\Item\ItemDropTest.cs", "C#", 0, 0, 39, 0, 1, 7, 47
"e:\UNITY\Unity Learning\Project2D\Assets\_Data\Item\ItemProfileSO.cs", "C#", 0, 0, 19, 0, 0, 3, 22
"e:\UNITY\Unity Learning\Project2D\Assets\_Data\Item\ItemType.cs", "C#", 0, 0, 6, 0, 0, 2, 8
"e:\UNITY\Unity Learning\Project2D\Assets\_Data\Junk\JunkAbstract.cs", "C#", 0, 0, 17, 0, 0, 4, 21
"e:\UNITY\Unity Learning\Project2D\Assets\_Data\Junk\JunkCtrl.cs", "C#", 0, 0, 34, 0, 0, 8, 42
"e:\UNITY\Unity Learning\Project2D\Assets\_Data\Junk\JunkDamageReciver.cs", "C#", 0, 0, 39, 0, 0, 10, 49
"e:\UNITY\Unity Learning\Project2D\Assets\_Data\Junk\JunkDespawn.cs", "C#", 0, 0, 13, 0, 0, 3, 16
"e:\UNITY\Unity Learning\Project2D\Assets\_Data\Junk\JunkFly.cs", "C#", 0, 0, 32, 0, 0, 9, 41
"e:\UNITY\Unity Learning\Project2D\Assets\_Data\Junk\Spawner\JunkSpawner.cs", "C#", 0, 0, 15, 0, 0, 4, 19
"e:\UNITY\Unity Learning\Project2D\Assets\_Data\Junk\Spawner\JunkSpawnerCtrl.cs", "C#", 0, 0, 25, 0, 0, 5, 30
"e:\UNITY\Unity Learning\Project2D\Assets\_Data\Map\MapCtrl.cs", "C#", 0, 0, 12, 0, 2, 5, 19
"e:\UNITY\Unity Learning\Project2D\Assets\_Data\Map\MapLevel.cs", "C#", 0, 0, 15, 0, 0, 3, 18
"e:\UNITY\Unity Learning\Project2D\Assets\_Data\Map\WormHole\WormHole.cs", "C#", 0, 0, 14, 0, 0, 4, 18
"e:\UNITY\Unity Learning\Project2D\Assets\_Data\Object\IObjAppearObserver.cs", "C#", 0, 0, 8, 0, 0, 3, 11
"e:\UNITY\Unity Learning\Project2D\Assets\_Data\Object\ObjAppearBigger.cs", "C#", 0, 0, 30, 0, 0, 6, 36
"e:\UNITY\Unity Learning\Project2D\Assets\_Data\Object\ObjAppearWithoutShoot.cs", "C#", 0, 0, 34, 0, 1, 11, 46
"e:\UNITY\Unity Learning\Project2D\Assets\_Data\Object\ObjAppearing.cs", "C#", 0, 0, 43, 0, 0, 11, 54
"e:\UNITY\Unity Learning\Project2D\Assets\_Data\Object\ObjLook.cs", "C#", 0, 0, 21, 0, 0, 5, 26
"e:\UNITY\Unity Learning\Project2D\Assets\_Data\Object\ObjLookAtMouse.cs", "C#", 0, 0, 14, 0, 0, 4, 18
"e:\UNITY\Unity Learning\Project2D\Assets\_Data\Object\ObjLookAtPlayer.cs", "C#", 0, 0, 16, 0, 1, 4, 21
"e:\UNITY\Unity Learning\Project2D\Assets\_Data\Object\ObjLookAtTarget.cs", "C#", 0, 0, 19, 0, 0, 5, 24
"e:\UNITY\Unity Learning\Project2D\Assets\_Data\Object\ObjMoveForward.cs", "C#", 0, 0, 36, 0, 0, 9, 45
"e:\UNITY\Unity Learning\Project2D\Assets\_Data\Object\ObjMovement.cs", "C#", 0, 0, 22, 0, 1, 7, 30
"e:\UNITY\Unity Learning\Project2D\Assets\_Data\Object\ObjShooting.cs", "C#", 0, 0, 57, 0, 1, 13, 71
"e:\UNITY\Unity Learning\Project2D\Assets\_Data\Player\PlayerAbilities.cs", "C#", 0, 0, 45, 0, 0, 8, 53
"e:\UNITY\Unity Learning\Project2D\Assets\_Data\Player\PlayerAbstract.cs", "C#", 0, 0, 17, 0, 0, 4, 21
"e:\UNITY\Unity Learning\Project2D\Assets\_Data\Player\PlayerCtrl.cs", "C#", 0, 0, 39, 0, 0, 10, 49
"e:\UNITY\Unity Learning\Project2D\Assets\_Data\Player\PlayerPickup.cs", "C#", 0, 0, 13, 0, 0, 3, 16
"e:\UNITY\Unity Learning\Project2D\Assets\_Data\Scripts\DamageReciver.cs", "C#", 0, 0, 52, 0, 0, 12, 64
"e:\UNITY\Unity Learning\Project2D\Assets\_Data\Scripts\DamageSender.cs", "C#", 0, 0, 29, 0, 0, 8, 37
"e:\UNITY\Unity Learning\Project2D\Assets\_Data\Scripts\FollowTarget.cs", "C#", 0, 0, 21, 0, 0, 7, 28
"e:\UNITY\Unity Learning\Project2D\Assets\_Data\Scripts\GameCtrl.cs", "C#", 0, 0, 33, 0, 0, 8, 41
"e:\UNITY\Unity Learning\Project2D\Assets\_Data\Scripts\JunkRotate.cs", "C#", 0, 0, 14, 0, 0, 3, 17
"e:\UNITY\Unity Learning\Project2D\Assets\_Data\Scripts\Level.cs", "C#", 0, 0, 23, 0, 0, 6, 29
"e:\UNITY\Unity Learning\Project2D\Assets\_Data\Scripts\LevelByDistance.cs", "C#", 0, 0, 25, 0, 0, 6, 31
"e:\UNITY\Unity Learning\Project2D\Assets\_Data\Scripts\MissleDamageSender.cs", "C#", 0, 0, 11, 0, 0, 2, 13
"e:\UNITY\Unity Learning\Project2D\Assets\_Data\Scripts\ParentFly.cs", "C#", 0, 0, 14, 0, 0, 4, 18
"e:\UNITY\Unity Learning\Project2D\Assets\_Data\Scripts\RandomStringGenerator.cs", "C#", 0, 0, 15, 0, 0, 3, 18
"e:\UNITY\Unity Learning\Project2D\Assets\_Data\Scripts\ScreenShake.cs", "C#", 0, 0, 34, 0, 0, 7, 41
"e:\UNITY\Unity Learning\Project2D\Assets\_Data\Scripts\ShieldDamageReceiver.cs", "C#", 0, 0, 29, 0, 0, 5, 34
"e:\UNITY\Unity Learning\Project2D\Assets\_Data\Scripts\ShipSelect.cs", "C#", 0, 0, 62, 0, 0, 10, 72
"e:\UNITY\Unity Learning\Project2D\Assets\_Data\Scripts\SpawnPoints.cs", "C#", 0, 0, 23, 0, 0, 5, 28
"e:\UNITY\Unity Learning\Project2D\Assets\_Data\Ship\ShipCode.cs", "C#", 0, 0, 21, 0, 0, 4, 25
"e:\UNITY\Unity Learning\Project2D\Assets\_Data\Ship\ShipCtrl.cs", "C#", 0, 0, 21, 0, 0, 7, 28
"e:\UNITY\Unity Learning\Project2D\Assets\_Data\Ship\ShipDamageReceiver.cs", "C#", 0, 0, 40, 0, 0, 10, 50
"e:\UNITY\Unity Learning\Project2D\Assets\_Data\Ship\ShipFollowMouse.cs", "C#", 0, 0, 14, 0, 0, 4, 18
"e:\UNITY\Unity Learning\Project2D\Assets\_Data\Ship\ShipFollowTarget.cs", "C#", 0, 0, 19, 0, 0, 6, 25
"e:\UNITY\Unity Learning\Project2D\Assets\_Data\Ship\ShipShootByDis.cs", "C#", 0, 0, 23, 0, 0, 6, 29
"e:\UNITY\Unity Learning\Project2D\Assets\_Data\Ship\ShipShootByMouse.cs", "C#", 0, 0, 10, 0, 0, 3, 13
"e:\UNITY\Unity Learning\Project2D\Assets\_Data\Ship\ShipSpawner.cs", "C#", 0, 0, 17, 0, 0, 4, 21
"e:\UNITY\Unity Learning\Project2D\Assets\_Data\Ship\ShipsManager.cs", "C#", 0, 0, 43, 0, 1, 12, 56
"e:\UNITY\Unity Learning\Project2D\Assets\_Data\ShootableObject\AbilityObject\AbilityObjectCtrl.cs", "C#", 0, 0, 18, 0, 0, 4, 22
"e:\UNITY\Unity Learning\Project2D\Assets\_Data\ShootableObject\Enemy\EnemyCtrl.cs", "C#", 0, 0, 9, 0, 0, 3, 12
"e:\UNITY\Unity Learning\Project2D\Assets\_Data\ShootableObject\Enemy\EnemyDespawn.cs", "C#", 0, 0, 13, 0, 0, 3, 16
"e:\UNITY\Unity Learning\Project2D\Assets\_Data\ShootableObject\Enemy\EnemySpawner.cs", "C#", 0, 0, 13, 0, 0, 3, 16
"e:\UNITY\Unity Learning\Project2D\Assets\_Data\ShootableObject\Enemy\MotherShipDespawn.cs", "C#", 0, 0, 13, 0, 0, 4, 17
"e:\UNITY\Unity Learning\Project2D\Assets\_Data\ShootableObject\Enemy\MotherShipSpawner.cs", "C#", 0, 0, 13, 0, 0, 3, 16
"e:\UNITY\Unity Learning\Project2D\Assets\_Data\ShootableObject\ShootableObjectAbstract.cs", "C#", 0, 0, 17, 0, 0, 4, 21
"e:\UNITY\Unity Learning\Project2D\Assets\_Data\ShootableObject\ShootableObjectCtrl.cs", "C#", 0, 0, 67, 0, 0, 17, 84
"e:\UNITY\Unity Learning\Project2D\Assets\_Data\ShootableObject\ShootableObjectDamageReciver.cs", "C#", 0, 0, 40, 0, 0, 10, 50
"e:\UNITY\Unity Learning\Project2D\Assets\_Data\ShootableObject\ShootableObjectSO.cs", "C#", 0, 0, 18, 0, 0, 3, 21
"e:\UNITY\Unity Learning\Project2D\Assets\_Data\ShootableObject\ShootableObjectSpawnerWithHPBar.cs", "C#", 0, 0, 12, 0, 0, 3, 15
"e:\UNITY\Unity Learning\Project2D\Assets\_Data\ShootableObject\ShootableObjectType.cs", "C#", 0, 0, 8, 0, 0, 3, 11
"e:\UNITY\Unity Learning\Project2D\Assets\_Data\Spawner\Spawner.cs", "C#", 0, 0, 84, 0, 0, 19, 103
"e:\UNITY\Unity Learning\Project2D\Assets\_Data\Spawner\SpawnerCtrl.cs", "C#", 0, 0, 25, 0, 0, 6, 31
"e:\UNITY\Unity Learning\Project2D\Assets\_Data\Spawner\SpawnerRandom.cs", "C#", 0, 0, 49, 0, 0, 9, 58
"e:\UNITY\Unity Learning\Project2D\Assets\_Data\UI\Buttons\BaseButton.cs", "C#", 0, 0, 25, 0, 0, 6, 31
"e:\UNITY\Unity Learning\Project2D\Assets\_Data\UI\Buttons\BtnExitGame.cs", "C#", 0, 0, 12, 0, 0, 2, 14
"e:\UNITY\Unity Learning\Project2D\Assets\_Data\UI\Buttons\ButtonEnterGame.cs", "C#", 0, 0, 12, 0, 0, 2, 14
"e:\UNITY\Unity Learning\Project2D\Assets\_Data\UI\HPBar\HPBar.cs", "C#", 0, 0, 52, 0, 0, 15, 67
"e:\UNITY\Unity Learning\Project2D\Assets\_Data\UI\HotKey\Cooldown.cs", "C#", 0, 0, 41, 0, 7, 9, 57
"e:\UNITY\Unity Learning\Project2D\Assets\_Data\UI\HotKey\DragItem.cs", "C#", 0, 0, 49, 0, 0, 10, 59
"e:\UNITY\Unity Learning\Project2D\Assets\_Data\UI\HotKey\HotKeySlot.cs", "C#", 0, 0, 57, 0, 1, 10, 68
"e:\UNITY\Unity Learning\Project2D\Assets\_Data\UI\HotKey\OnPressAlpha.cs", "C#", 0, 0, 24, 0, 1, 5, 30
"e:\UNITY\Unity Learning\Project2D\Assets\_Data\UI\HotKey\Pressable\Pressable.cs", "C#", 0, 0, 7, 0, 0, 2, 9
"e:\UNITY\Unity Learning\Project2D\Assets\_Data\UI\HotKey\Pressable\PressableAbility.cs", "C#", 0, 0, 17, 0, 0, 2, 19
"e:\UNITY\Unity Learning\Project2D\Assets\_Data\UI\HotKey\UIHotKeyCtrl.cs", "C#", 0, 0, 27, 0, 0, 6, 33
"e:\UNITY\Unity Learning\Project2D\Assets\_Data\UI\Inventory\BtnCloseInventory.cs", "C#", 0, 0, 10, 0, 0, 2, 12
"e:\UNITY\Unity Learning\Project2D\Assets\_Data\UI\Inventory\BtnOpenInventory.cs", "C#", 0, 0, 10, 0, 0, 2, 12
"e:\UNITY\Unity Learning\Project2D\Assets\_Data\UI\Inventory\InventoryOrderBy.cs", "C#", 0, 0, 8, 0, 0, 2, 10
"e:\UNITY\Unity Learning\Project2D\Assets\_Data\UI\Inventory\InventorySort.cs", "C#", 0, 0, 9, 0, 0, 2, 11
"e:\UNITY\Unity Learning\Project2D\Assets\_Data\UI\Inventory\UIInventory.cs", "C#", 0, 0, 90, 0, 1, 18, 109
"e:\UNITY\Unity Learning\Project2D\Assets\_Data\UI\Inventory\UIInventoryAbstract.cs", "C#", 0, 0, 19, 0, 0, 4, 23
"e:\UNITY\Unity Learning\Project2D\Assets\_Data\UI\Inventory\UIInventoryCtrl.cs", "C#", 0, 0, 28, 0, 0, 6, 34
"e:\UNITY\Unity Learning\Project2D\Assets\_Data\UI\Inventory\UIInventoryItemSpawner.cs", "C#", 0, 0, 42, 0, 0, 10, 52
"e:\UNITY\Unity Learning\Project2D\Assets\_Data\UI\Inventory\UIItemInventory.cs", "C#", 0, 0, 43, 0, 0, 10, 53
"e:\UNITY\Unity Learning\Project2D\Assets\_Data\UI\Slider\BaseSlider.cs", "C#", 0, 0, 27, 0, 1, 7, 35
"e:\UNITY\Unity Learning\Project2D\Assets\_Data\UI\Slider\SliderHp.cs", "C#", 0, 0, 24, 0, 1, 6, 31
"e:\UNITY\Unity Learning\Project2D\Assets\_Data\UI\Text\BaseText.cs", "C#", 0, 0, 16, 0, 0, 6, 22
"e:\UNITY\Unity Learning\Project2D\Assets\_Data\UI\Text\TextShipHp.cs", "C#", 0, 0, 14, 0, 0, 3, 17
"e:\UNITY\Unity Learning\Project2D\Packages\manifest.json", "JSON", 45, 0, 0, 0, 0, 1, 46
"e:\UNITY\Unity Learning\Project2D\Packages\packages-lock.json", "JSON", 483, 0, 0, 0, 0, 1, 484
"e:\UNITY\Unity Learning\Project2D\README.md", "Markdown", 0, 2, 0, 0, 0, 1, 3
"Total", "-", 683, 2, 4127, 2338, 181, 1610, 8941